16x16
EEEEEEEEEEEEWEEE
EEEEEEEEEEEWWEEE
EEEEEEEEEEEWEEEE
EEEEEEEEWWWWEEEE
EEEEEEEEWEEEEEEE
EEEEEEEEBEEEEEEW
EEEEEEEEWEEEEEWW
EEEEEEEWWWEEEEWW
EEEEEEEWEWEEEWWW
EEEEEEWWEWEEEWWW
EEEEEEWEEWEEEWWW
EEEEEWWEEWWEWWWW
EEEEEWEEEEWWWWWW
EEEWBWEEEEWWWWWE
EEWWEEEEEEEWWWWW
EEWEEEEEEEEEEEEE
